0000011111011111
1011000000000001
1011110101011101
1000000000000001
1010111110111011
1010000000110000
1010111110111011
1010000110000001
1001111111011100
